##########--####
#--------------#
#--------------#
#--------------#
#--------------#
#-------E------#
#------####----#
#-D----------E-#
################