##########--####
#--------------#
#--------------#
#--------------#
#--------------#
#--------------#
#------####----#
#-D---------E--#
################