##########--###
#-------------#
#-------------#
#-------------#
#-----######--#
#-------##----#
###############