##########--####
#--------------#
#--------------#
#--------------#
#--------------#
#--------------#
#------####----#
#-D------------#
################