##########--###
#-------------#
#-------------#
#-------------#
#-----######--#
#-D-----##----#
###############