##########--####
#--------------#
#--------------#
#--------------#
#--------------#
#--------------#
#------####----#
#-D---##-------#
################