----------------
---------#------
------###-------
-----------E----
-###------------
----------D-----
-------####--B--
-##############-
----------------